year,fempgr_gr,firms,estabs,emp,denom,estabs_entry,estabs_entry_rate,estabs_exit,estabs_exit_rate,job_creation,job_creation_births,job_creation_continuers,job_creation_rate_births,job_creation_rate,job_destruction,job_destruction_deaths,job_destruction_continuers,job_destruction_rate_deaths,job_destruction_rate,net_job_creation,net_job_creation_rate,reallocation_rate,firmdeath_firms,firmdeath_estabs,firmdeath_emp
1978,a) -2,0,0,0,1117400,0,0.000,411170,200.000,0,0,0,0.000,0.000,2234799,2234799,0,200.000,200.000,-2234799,-200.000,0.000,326342,331467,1821380
1978,b) (-2 to -0.8],87525,93974,365093,909027,795,0.829,4644,4.843,11485,5801,5684,0.638,1.263,1107507,99602,1007905,10.957,121.834,-1096022,-120.571,2.527,0,0,0
1978,c) (-0.8 to -0.2],414877,466962,3934271,4864721,5209,1.112,8458,1.805,155668,62106,93562,1.277,3.200,2024068,230252,1793816,4.733,41.607,-1868400,-38.407,6.400,0,0,0
1978,d) (-0.2 to -0.01],201692,364244,11737418,12201523,14324,3.932,14383,3.948,714640,233930,480710,1.917,5.857,1644346,332115,1312231,2.722,13.477,-929706,-7.620,11.714,0,0,0
1978,e) (-0.01 to 0.01),1083993,1150680,7083750,7082277,6330,0.551,4246,0.369,289892,86059,203833,1.215,4.093,288282,87542,200740,1.236,4.070,1610,0.023,8.141,0,0,0
1978,f) [0.01 to 0.2),299437,625322,27710978,26653537,33651,5.441,20026,3.238,3545875,719603,2826272,2.700,13.304,1432496,434414,998082,1.630,5.375,2113379,7.929,10.749,0,0,0
1978,g) [0.2 to 0.8),762027,893757,13933690,11719858,26400,2.983,8737,0.987,4786135,532722,4253413,4.545,40.838,344547,140354,204193,1.198,2.940,4441588,37.898,5.880,0,0,0
1978,h) [0.8 to 2),169813,183727,2713630,1733055,7245,4.014,740,0.410,1989286,189260,1800026,10.921,114.785,16820,7018,9802,0.405,0.971,1972466,113.814,1.941,0,0,0
1978,i) 2,539317,547166,2758657,1379329,547166,200.000,0,0.000,2758657,2758657,0,200.000,200.000,0,0,0,0.000,0.000,2758657,200.000,0.000,0,0,0
1979,a) -2,0,0,0,1128317,0,0.000,418233,200.000,0,0,0,0.000,0.000,2256634,2256634,0,200.000,200.000,-2256634,-200.000,0.000,330113,334625,1788168
1979,b) (-2 to -0.8],124856,130622,458173,1132609,517,0.391,3648,2.760,7068,4621,2447,0.408,0.624,1367661,78087,1289574,6.894,120.753,-1360593,-120.129,1.248,0,0,0
1979,c) (-0.8 to -0.2],498627,552678,4616900,5706402,4694,0.847,7833,1.413,132677,70771,61906,1.240,2.325,2322395,165667,2156728,2.903,40.698,-2189718,-38.373,4.650,0,0,0
1979,d) (-0.2 to -0.01],234232,400073,12960623,13484353,14000,3.509,11809,2.960,646727,246533,400194,1.828,4.796,1693730,264376,1429354,1.961,12.561,-1047003,-7.765,9.592,0,0,0
1979,e) (-0.01 to 0.01),1132961,1213259,7970823,7968735,4881,0.403,3662,0.302,274559,85247,189312,1.070,3.445,269482,68271,201211,0.857,3.382,5077,0.064,6.763,0,0,0
1979,f) [0.01 to 0.2),321585,676465,30514132,29293502,32596,4.876,16576,2.480,3748141,774833,2973308,2.645,12.795,1313415,345935,967480,1.181,4.484,2434726,8.311,8.967,0,0,0
1979,g) [0.2 to 0.8),688178,807002,12872225,10846435,17975,2.246,4703,0.588,4272451,410879,3861572,3.788,39.390,210175,68339,141836,0.630,1.938,4062276,37.453,3.875,0,0,0
1979,h) [0.8 to 2),158006,167167,2632900,1667733,3113,1.878,378,0.228,1953709,100455,1853254,6.023,117.148,10266,6331,3935,0.380,0.616,1943443,116.532,1.231,0,0,0
1979,i) 2,533321,538396,2670049,1335025,538396,200.000,0,0.000,2670049,2670049,0,200.000,200.000,0,0,0,0.000,0.000,2670049,200.000,0.000,0,0,0
1980,a) -2,0,0,0,1209699,0,0.000,464811,200.000,0,0,0,0.000,0.000,2419397,2419397,0,200.000,200.000,-2419397,-200.000,0.000,369197,374201,1939210
1980,b) (-2 to -0.8],151160,158139,607064,1460555,687,0.430,3853,2.412,10506,5898,4608,0.404,0.719,1731686,85503,1646183,5.854,118.564,-1721180,-117.844,1.439,0,0,0
1980,c) (-0.8 to -0.2],622701,691665,6431930,7948025,5242,0.756,9049,1.305,129343,66934,62409,0.842,1.627,3167934,193535,2974399,2.435,39.858,-3038591,-38.231,3.255,0,0,0
1980,d) (-0.2 to -0.01],285789,519659,18331719,19085610,14591,2.806,15403,2.962,871221,310245,560976,1.626,4.565,2382178,364255,2017923,1.909,12.482,-1510957,-7.917,9.130,0,0,0
1980,e) (-0.01 to 0.01),1194298,1268904,8662928,8663642,4948,0.390,3067,0.242,286465,95563,190902,1.103,3.307,287353,62548,224805,0.722,3.317,-888,-0.010,6.613,0,0,0
1980,f) [0.01 to 0.2),289590,617523,26653112,25686119,28871,4.732,13981,2.292,3180514,661981,2518533,2.577,12.382,1249238,303009,946229,1.180,4.863,1931276,7.519,9.727,0,0,0
1980,g) [0.2 to 0.8),568023,653789,9756226,8214119,14546,2.244,3502,0.540,3247654,336033,2911621,4.091,39.537,156151,56841,99310,0.692,1.901,3091503,37.636,3.802,0,0,0
1980,h) [0.8 to 2),125734,134325,2096296,1325748,2758,2.071,469,0.352,1558765,74740,1484025,5.638,117.576,7029,3907,3122,0.295,0.530,1551736,117.046,1.060,0,0,0
1980,i) 2,501959,506739,2508482,1254241,506739,200.000,0,0.000,2508482,2508482,0,200.000,200.000,0,0,0,0.000,0.000,2508482,200.000,0.000,0,0,0
1981,a) -2,0,0,0,1241594,0,0.000,479877,200.000,0,0,0,0.000,0.000,2483188,2483188,0,200.000,200.000,-2483188,-200.000,0.000,377139,383423,1997150
1981,b) (-2 to -0.8],141431,148340,551366,1360406,546,0.365,3432,2.291,8252,4838,3414,0.356,0.607,1640041,68278,1571763,5.019,120.555,-1631789,-119.949,1.213,0,0,0
1981,c) (-0.8 to -0.2],585346,651491,6199816,7625681,5267,0.807,6855,1.051,136864,70918,65946,0.930,1.795,3000199,188723,2811476,2.475,39.343,-2863335,-37.549,3.590,0,0,0
1981,d) (-0.2 to -0.01],287674,552223,21057289,21878402,17345,3.148,14703,2.669,1025013,399367,625646,1.825,4.685,2668188,416962,2251226,1.906,12.196,-1643175,-7.510,9.370,0,0,0
1981,e) (-0.01 to 0.01),1238704,1340141,10126568,10123928,5720,0.427,3823,0.285,566269,118568,447701,1.171,5.593,560207,64726,495481,0.639,5.533,6062,0.060,11.067,0,0,0
1981,f) [0.01 to 0.2),295281,592783,23173987,22321726,29248,5.011,10928,1.872,2610294,660717,1949577,2.960,11.694,908531,213366,695165,0.956,4.070,1701763,7.624,8.140,0,0,0
1981,g) [0.2 to 0.8),587736,680239,9528486,8003236,19302,2.872,2976,0.443,3206947,366086,2840861,4.574,40.071,148739,47496,101243,0.593,1.858,3058208,38.212,3.717,0,0,0
1981,h) [0.8 to 2),130322,141385,2299689,1433352,4334,3.110,301,0.216,1749943,110448,1639495,7.706,122.087,8941,3568,5373,0.249,0.624,1741002,121.464,1.248,0,0,0
1981,i) 2,501781,504879,2843112,1421556,504879,200.000,0,0.000,2843112,2843112,0,200.000,200.000,0,0,0,0.000,0.000,2843112,200.000,0.000,0,0,0
1982,a) -2,0,0,0,1332630,0,0.000,512217,200.000,0,0,0,0.000,0.000,2665259,2665259,0,200.000,200.000,-2665259,-200.000,0.000,406314,412248,2221116
1982,b) (-2 to -0.8],146416,156054,660554,1601515,854,0.540,5018,3.173,11522,6956,4566,0.434,0.719,1904049,134347,1769702,8.389,118.890,-1892527,-118.171,1.439,0,0,0
1982,c) (-0.8 to -0.2],606964,698284,7055484,8688510,6373,0.909,12751,1.818,189185,87766,101419,1.010,2.177,3464398,265357,3199041,3.054,39.873,-3275213,-37.696,4.355,0,0,0
1982,d) (-0.2 to -0.01],287289,589679,23261728,24257727,19812,3.355,21386,3.622,1277232,430738,846494,1.776,5.265,3267459,494864,2772595,2.040,13.470,-1990227,-8.205,10.531,0,0,0
1982,e) (-0.01 to 0.01),1191567,1262528,8228472,8225404,5072,0.402,4092,0.324,262485,84159,178326,1.023,3.191,260184,56320,203864,0.685,3.163,2301,0.028,6.326,0,0,0
1982,f) [0.01 to 0.2),285023,562318,21300078,20467713,27467,4.957,11025,1.990,2506228,545791,1960437,2.667,12.245,846351,188259,658092,0.920,4.135,1659877,8.110,8.270,0,0,0
1982,g) [0.2 to 0.8),601620,699655,9468355,7942592,16607,2.395,4138,0.597,3226740,325707,2901033,4.101,40.626,165413,51047,114366,0.643,2.083,3061327,38.543,4.165,0,0,0
1982,h) [0.8 to 2),139606,156323,2401604,1511104,6716,4.384,487,0.318,1804177,151289,1652888,10.012,119.395,9726,3443,6283,0.228,0.644,1794451,118.751,1.287,0,0,0
1982,i) 2,483310,492010,2587877,1293939,492010,200.000,0,0.000,2587877,2587877,0,200.000,200.000,0,0,0,0.000,0.000,2587877,200.000,0.000,0,0,0
1983,a) -2,0,0,0,1256965,0,0.000,460674,200.000,0,0,0,0.000,0.000,2513930,2513930,0,200.000,200.000,-2513930,-200.000,0.000,363039,370051,2097247
1983,b) (-2 to -0.8],129262,139656,619519,1523871,1106,0.777,6522,4.581,15667,10523,5144,0.691,1.028,1835222,156576,1678646,10.275,120.432,-1819555,-119.404,2.056,0,0,0
1983,c) (-0.8 to -0.2],577542,693865,8256784,10137654,8495,1.216,18058,2.585,487377,108936,378441,1.075,4.808,4252871,581663,3671208,5.738,41.951,-3765494,-37.144,9.615,0,0,0
1983,d) (-0.2 to -0.01],288666,582688,21564007,22465256,20994,3.600,22106,3.790,1152796,382090,770706,1.701,5.131,2956053,470385,2485668,2.094,13.158,-1803257,-8.027,10.263,0,0,0
1983,e) (-0.01 to 0.01),1285149,1369885,8890983,8894313,6246,0.456,4695,0.343,338497,107119,231378,1.204,3.806,344107,86858,257249,0.977,3.869,-5610,-0.063,7.612,0,0,0
1983,f) [0.01 to 0.2),296082,561809,20296601,19532610,23866,4.291,12704,2.284,2491511,541193,1950318,2.771,12.756,963461,245757,717704,1.258,4.933,1528050,7.823,9.865,0,0,0
1983,g) [0.2 to 0.8),591935,686932,9437933,7931540,15916,2.337,4104,0.603,3257346,321144,2936202,4.049,41.068,236601,48192,188409,0.608,2.983,3020745,38.085,5.966,0,0,0
1983,h) [0.8 to 2),122992,132834,2102897,1318207,2987,2.271,370,0.281,1589521,87170,1502351,6.613,120.582,9781,3595,6186,0.273,0.742,1579740,119.840,1.484,0,0,0
1983,i) 2,538975,544281,2832268,1416134,544281,200.000,0,0.000,2832268,2832268,0,200.000,200.000,0,0,0,0.000,0.000,2832268,200.000,0.000,0,0,0
1984,a) -2,0,0,0,1243041,0,0.000,455937,200.000,0,0,0,0.000,0.000,2486082,2486082,0,200.000,200.000,-2486082,-200.000,0.000,364744,371117,2067676
1984,b) (-2 to -0.8],109498,116302,433968,1082422,381,0.322,4086,3.458,6264,3102,3162,0.287,0.579,1314937,87954,1226983,8.126,121.481,-1308673,-120.902,1.157,0,0,0
1984,c) (-0.8 to -0.2],497550,558835,4665733,5722468,4089,0.729,8019,1.430,134426,52491,81935,0.917,2.349,2258623,147922,2110701,2.585,39.469,-2124197,-37.120,4.698,0,0,0
1984,d) (-0.2 to -0.01],257545,455850,14629037,15187842,12408,2.717,14137,3.095,713262,233672,479590,1.539,4.696,1833453,295737,1537716,1.947,12.072,-1120191,-7.376,9.393,0,0,0
1984,e) (-0.01 to 0.01),1298288,1394871,9370931,9370322,4542,0.326,4775,0.342,332537,80640,251897,0.861,3.549,330951,79371,251580,0.847,3.532,1586,0.017,7.064,0,0,0
1984,f) [0.01 to 0.2),344934,746486,30149305,28968597,35776,4.851,17731,2.404,3896277,1012071,2884206,3.494,13.450,1537628,465087,1072541,1.605,5.308,2358649,8.142,10.616,0,0,0
1984,g) [0.2 to 0.8),716543,839425,13457580,11338456,17487,2.100,4109,0.493,4462601,473110,3989491,4.173,39.358,215647,64507,151140,0.569,1.902,4246954,37.456,3.804,0,0,0
1984,h) [0.8 to 2),161653,170634,2788759,1754947,2959,1.747,360,0.213,2088550,95560,1992990,5.445,119.009,7824,2563,5261,0.146,0.446,2080726,118.564,0.892,0,0,0
1984,i) 2,615174,620795,3159555,1579778,620795,200.000,0,0.000,3159555,3159555,0,200.000,200.000,0,0,0,0.000,0.000,3159555,200.000,0.000,0,0,0
1985,a) -2,0,0,0,1751388,0,0.000,544592,200.000,0,0,0,0.000,0.000,3502776,3502776,0,200.000,200.000,-3502776,-200.000,0.000,431657,440689,2816160
1985,b) (-2 to -0.8],125432,132632,501398,1312747,341,0.252,5833,4.309,5764,2629,3135,0.200,0.439,1640490,157953,1482537,12.032,124.966,-1634726,-124.527,0.878,0,0,0
1985,c) (-0.8 to -0.2],550813,611046,5554434,6835689,2930,0.478,6147,1.003,161349,67552,93797,0.988,2.360,2732089,186491,2545598,2.728,39.968,-2570740,-37.608,4.721,0,0,0
1985,d) (-0.2 to -0.01],276864,505432,17521008,18200728,14014,2.767,16158,3.190,904552,283870,620682,1.560,4.970,2262542,390787,1871755,2.147,12.431,-1357990,-7.461,9.940,0,0,0
1985,e) (-0.01 to 0.01),1302095,1401730,10044539,10040802,3842,0.274,8024,0.572,346395,79336,267059,0.790,3.450,340825,112280,228545,1.118,3.394,5570,0.055,6.789,0,0,0
1985,f) [0.01 to 0.2),349597,734987,28880646,27757449,32686,4.498,16011,2.203,3568669,860690,2707979,3.101,12.857,1324131,394535,929596,1.421,4.770,2244538,8.086,9.541,0,0,0
1985,g) [0.2 to 0.8),708583,824690,12604868,10611638,17721,2.168,3346,0.409,4207374,414927,3792447,3.910,39.649,211333,68694,142639,0.647,1.992,3996041,37.657,3.983,0,0,0
1985,h) [0.8 to 2),156808,166857,3140197,1952535,3404,2.059,354,0.214,2396055,128443,2267612,6.578,122.715,7883,3308,4575,0.169,0.404,2388172,122.311,0.807,0,0,0
1985,i) 2,602753,608111,3331734,1665867,608111,200.000,0,0.000,3331734,3331734,0,200.000,200.000,0,0,0,0.000,0.000,3331734,200.000,0.000,0,0,0
1986,a) -2,0,0,0,1555612,0,0.000,525997,200.000,0,0,0,0.000,0.000,3111224,3111224,0,200.000,200.000,-3111224,-200.000,0.000,414723,422550,2553227
1986,b) (-2 to -0.8],131944,140776,602883,1600616,731,0.512,4626,3.241,13415,7491,5924,0.468,0.838,2020738,116279,1904459,7.265,126.248,-2007323,-125.409,1.676,0,0,0
1986,c) (-0.8 to -0.2],579575,654084,6065392,7479766,7361,1.124,9065,1.384,174905,79824,95081,1.067,2.338,3010973,214258,2796715,2.865,40.255,-2836068,-37.917,4.677,0,0,0
1986,d) (-0.2 to -0.01],296028,574720,20799004,21619854,21718,3.784,20218,3.522,1160251,422810,737441,1.956,5.367,2802621,474100,2328521,2.193,12.963,-1642370,-7.597,10.733,0,0,0
1986,e) (-0.01 to 0.01),1332500,1430617,10439738,10436018,5835,0.408,3416,0.239,330293,100281,230012,0.961,3.165,322476,62250,260226,0.596,3.090,7817,0.075,6.180,0,0,0
1986,f) [0.01 to 0.2),353942,701394,26477146,25418842,36770,5.322,15869,2.297,3355714,827299,2528415,3.255,13.202,1241091,322107,918984,1.267,4.883,2114623,8.319,9.765,0,0,0
1986,g) [0.2 to 0.8),708904,838593,13033470,10952558,29374,3.556,4211,0.510,4422565,588548,3834017,5.374,40.379,253646,67490,186156,0.616,2.316,4168919,38.063,4.632,0,0,0
1986,h) [0.8 to 2),154407,167868,2886521,1814571,5797,3.511,301,0.182,2168433,162061,2006372,8.931,119.501,12012,3672,8340,0.202,0.662,2156421,118.839,1.324,0,0,0
1986,i) 2,600030,603617,3355204,1677602,603617,200.000,0,0.000,3355204,3355204,0,200.000,200.000,0,0,0,0.000,0.000,3355204,200.000,0.000,0,0,0
1987,a) -2,0,0,0,1733667,0,0.000,546447,200.000,0,0,0,0.000,0.000,3467334,3467334,0,200.000,200.000,-3467334,-200.000,0.000,435803,444145,2819043
1987,b) (-2 to -0.8],137903,147461,694328,1861379,899,0.597,7312,4.853,13011,7496,5515,0.403,0.699,2360145,199179,2160966,10.701,126.796,-2347134,-126.097,1.398,0,0,0
1987,c) (-0.8 to -0.2],604990,690308,6876008,8510331,7883,1.136,14946,2.154,253428,115836,137592,1.361,2.978,3532202,390595,3141607,4.590,41.505,-3278774,-38.527,5.956,0,0,0
1987,d) (-0.2 to -0.01],300297,575991,20431265,21304955,22336,3.862,27183,4.700,1303059,510550,792509,2.396,6.116,3051163,664294,2386869,3.118,14.321,-1748104,-8.205,12.232,0,0,0
1987,e) (-0.01 to 0.01),1334332,1425141,10033046,10030732,6629,0.465,6105,0.428,439055,156341,282714,1.559,4.377,433747,121886,311861,1.215,4.324,5308,0.053,8.648,0,0,0
1987,f) [0.01 to 0.2),354675,714207,27233652,26142246,40670,5.789,17337,2.468,3428549,929084,2499465,3.554,13.115,1243437,330792,912645,1.265,4.756,2185112,8.359,9.513,0,0,0
1987,g) [0.2 to 0.8),721364,869558,13593080,11419640,31909,3.722,7536,0.879,4642170,634476,4007694,5.556,40.651,286109,86089,200020,0.754,2.505,4356061,38.145,5.011,0,0,0
1987,h) [0.8 to 2),161224,182001,3133139,1963860,10516,5.937,773,0.436,2366034,258289,2107745,13.152,120.479,15266,5033,10233,0.256,0.777,2350768,119.701,1.555,0,0,0
1987,i) 2,608956,619504,3888664,1944332,619504,200.000,0,0.000,3888664,3888664,0,200.000,200.000,0,0,0,0.000,0.000,3888664,200.000,0.000,0,0,0
1988,a) -2,0,0,0,1672092,0,0.000,536586,200.000,0,0,0,0.000,0.000,3344184,3344184,0,200.000,200.000,-3344184,-200.000,0.000,425385,435338,2790551
1988,b) (-2 to -0.8],140756,152676,682370,1720106,957,0.611,8829,5.637,19343,8898,10445,0.517,1.125,2104768,230368,1874400,13.393,122.363,-2085425,-121.238,2.249,0,0,0
1988,c) (-0.8 to -0.2],631017,729649,6845971,8447623,8724,1.191,14547,1.986,274920,117975,156945,1.397,3.254,3486137,364649,3121488,4.317,41.268,-3211217,-38.013,6.509,0,0,0
1988,d) (-0.2 to -0.01],314222,594316,20011125,20842913,28250,4.772,23560,3.980,1231130,478429,752701,2.295,5.907,2896677,574348,2322329,2.756,13.898,-1665547,-7.991,11.813,0,0,0
1988,e) (-0.01 to 0.01),1358756,1443574,10092367,10093686,6077,0.421,3543,0.246,310458,96158,214300,0.953,3.076,312441,80020,232421,0.793,3.095,-1983,-0.020,6.152,0,0,0
1988,f) [0.01 to 0.2),372999,768902,29561196,28373976,47476,6.293,18628,2.469,3860045,946676,2913369,3.336,13.604,1480960,388192,1092768,1.368,5.219,2379085,8.385,10.439,0,0,0
1988,g) [0.2 to 0.8),733905,887565,14691598,12394214,31461,3.597,5546,0.634,4959726,804720,4155006,6.493,40.016,357399,104933,252466,0.847,2.884,4602327,37.133,5.767,0,0,0
1988,h) [0.8 to 2),156657,172821,3017121,1910633,6731,3.966,559,0.329,2254536,311535,1943001,16.305,117.999,30305,15348,14957,0.803,1.586,2224231,116.413,3.172,0,0,0
1988,i) 2,599612,609111,3485000,1742500,609111,200.000,0,0.000,3485000,3485000,0,200.000,200.000,0,0,0,0.000,0.000,3485000,200.000,0.000,0,0,0
1989,a) -2,0,0,0,1682845,0,0.000,545241,200.000,0,0,0,0.000,0.000,3365689,3365689,0,200.000,200.000,-3365689,-200.000,0.000,429504,441747,2785028
1989,b) (-2 to -0.8],136322,145265,564328,1385425,643,0.435,6066,4.099,11877,6152,5725,0.444,0.857,1666194,155333,1510861,11.212,120.266,-1654317,-119.409,1.715,0,0,0
1989,c) (-0.8 to -0.2],627020,713185,6486049,8013683,6882,0.962,11446,1.600,213253,98267,114986,1.226,2.661,3276939,272385,3004554,3.399,40.892,-3063686,-38.231,5.322,0,0,0
1989,d) (-0.2 to -0.01],322257,604469,20438015,21236788,20065,3.317,20801,3.439,1187495,407566,779929,1.919,5.592,2776618,549885,2226733,2.589,13.075,-1589123,-7.483,11.183,0,0,0
1989,e) (-0.01 to 0.01),1404926,1502788,10664690,10664211,5718,0.381,4681,0.312,378337,115824,262513,1.086,3.548,377024,132686,244338,1.244,3.535,1313,0.012,7.071,0,0,0
1989,f) [0.01 to 0.2),392443,853823,32694078,31376204,58103,6.962,19595,2.348,4236636,1119446,3117190,3.568,13.503,1603130,413871,1189259,1.319,5.109,2633506,8.393,10.219,0,0,0
1989,g) [0.2 to 0.8),748446,880433,14255480,12028491,24370,2.799,4724,0.543,4740555,585993,4154562,4.872,39.411,278825,92055,186770,0.765,2.318,4461730,37.093,4.636,0,0,0
1989,h) [0.8 to 2),157017,169479,2816973,1776638,5775,3.463,314,0.188,2109409,188181,1921228,10.592,118.730,15327,4325,11002,0.243,0.863,2094082,117.868,1.725,0,0,0
1989,i) 2,593240,601846,3416378,1708189,601846,200.000,0,0.000,3416378,3416378,0,200.000,200.000,0,0,0,0.000,0.000,3416378,200.000,0.000,0,0,0
1990,a) -2,0,0,0,1583032,0,0.000,534908,200.000,0,0,0,0.000,0.000,3166064,3166064,0,200.000,200.000,-3166064,-200.000,0.000,433885,444864,2720575
1990,b) (-2 to -0.8],142426,150201,579070,1442711,457,0.300,5181,3.396,7591,4225,3366,0.293,0.526,1748128,111253,1636875,7.711,121.170,-1740537,-120.643,1.052,0,0,0
1990,c) (-0.8 to -0.2],645286,724296,6739357,8302860,5136,0.707,10189,1.402,154241,68404,85837,0.824,1.858,3288495,207078,3081417,2.494,39.607,-3134254,-37.749,3.715,0,0,0
1990,d) (-0.2 to -0.01],339618,687332,23594341,24505260,27771,4.050,24522,3.576,1278924,467545,811379,1.908,5.219,3101781,541086,2560695,2.208,12.658,-1822857,-7.439,10.438,0,0,0
1990,e) (-0.01 to 0.01),1433956,1559899,11184534,11185940,6251,0.401,5065,0.325,385469,115227,270242,1.030,3.446,388430,87074,301356,0.778,3.472,-2961,-0.026,6.892,0,0,0
1990,f) [0.01 to 0.2),395128,808769,32205095,30948761,38684,4.845,18081,2.264,3878585,908573,2970012,2.936,12.532,1370834,355316,1015518,1.148,4.429,2507751,8.103,8.859,0,0,0
1990,g) [0.2 to 0.8),745826,877735,13351036,11255844,23981,2.763,4521,0.521,4469513,520694,3948819,4.626,39.708,274316,93352,180964,0.829,2.437,4195197,37.271,4.874,0,0,0
1990,h) [0.8 to 2),157571,168130,2683559,1698065,4679,2.819,365,0.220,1996968,142195,1854773,8.374,117.603,13313,4632,8681,0.273,0.784,1983655,116.819,1.568,0,0,0
1990,i) 2,585382,593021,3335452,1667726,593021,200.000,0,0.000,3335452,3335452,0,200.000,200.000,0,0,0,0.000,0.000,3335452,200.000,0.000,0,0,0
1991,a) -2,0,0,0,2003485,0,0.000,571907,200.000,0,0,0,0.000,0.000,4006970,4006970,0,200.000,200.000,-4006970,-200.000,0.000,453798,466567,3381817
1991,b) (-2 to -0.8],169016,177748,704715,1765102,914,0.507,6145,3.407,13406,8401,5005,0.476,0.760,2150595,145571,2005024,8.247,121.840,-2137189,-121.080,1.519,0,0,0
1991,c) (-0.8 to -0.2],729349,843857,8472978,10413934,11753,1.389,16430,1.942,280114,146110,134004,1.403,2.690,4172457,354422,3818035,3.403,40.066,-3892343,-37.376,5.380,0,0,0
1991,d) (-0.2 to -0.01],365815,808580,27559445,28706116,44214,5.513,31074,3.875,1666713,718559,948154,2.503,5.806,3960637,573174,3387463,1.997,13.797,-2293924,-7.991,11.612,0,0,0
1991,e) (-0.01 to 0.01),1458926,1567076,10932880,10932931,9057,0.579,3438,0.220,346960,141389,205571,1.293,3.174,346387,61079,285308,0.559,3.168,573,0.005,6.337,0,0,0
1991,f) [0.01 to 0.2),358928,745623,27312832,26298113,48941,6.718,14786,2.030,3344370,929896,2414474,3.536,12.717,1314690,277886,1036804,1.057,4.999,2029680,7.718,9.998,0,0,0
1991,g) [0.2 to 0.8),660629,774778,11340740,9598555,28951,3.796,4690,0.615,3772824,633152,3139672,6.596,39.306,276303,77095,199208,0.803,2.879,3496521,36.428,5.757,0,0,0
1991,h) [0.8 to 2),135785,146587,2225882,1398693,6059,4.217,260,0.181,1674926,130387,1544539,9.322,119.749,9470,3334,6136,0.238,0.677,1665456,119.072,1.354,0,0,0
1991,i) 2,533861,540180,2898836,1449418,540180,200.000,0,0.000,2898836,2898836,0,200.000,200.000,0,0,0,0.000,0.000,2898836,200.000,0.000,0,0,0
1992,a) -2,0,0,0,1595623,0,0.000,527813,200.000,0,0,0,0.000,0.000,3191245,3191245,0,200.000,200.000,-3191245,-200.000,0.000,415346,426543,2694229
1992,b) (-2 to -0.8],148381,156999,598061,1592759,589,0.367,7150,4.461,11207,5720,5487,0.359,0.704,2014873,178407,1836466,11.201,126.502,-2003666,-125.798,1.407,0,0,0
1992,c) (-0.8 to -0.2],668436,775736,7354038,9026938,7782,0.995,21014,2.686,231863,96142,135721,1.065,2.569,3588026,335509,3252517,3.717,39.748,-3356163,-37.179,5.137,0,0,0
1992,d) (-0.2 to -0.01],353608,796063,26862601,27938717,28652,3.567,43116,5.367,1718365,603661,1114704,2.161,6.150,3867594,879669,2987925,3.149,13.843,-2149229,-7.693,12.301,0,0,0
1992,e) (-0.01 to 0.01),1492841,1606804,11863035,11862507,7244,0.451,8305,0.517,466287,144697,321590,1.220,3.931,464943,115665,349278,0.975,3.919,1344,0.011,7.839,0,0,0
1992,f) [0.01 to 0.2),371940,752598,27539457,26490499,35611,4.783,19454,2.613,3431323,742728,2688595,2.804,12.953,1336383,348972,987411,1.317,5.045,2094940,7.908,10.090,0,0,0
1992,g) [0.2 to 0.8),701006,822134,11593060,9754247,24292,2.987,6402,0.787,3900389,438180,3462209,4.492,39.987,216886,62481,154405,0.641,2.224,3683503,37.763,4.447,0,0,0
1992,h) [0.8 to 2),150238,167673,2715190,1708596,9054,5.537,731,0.447,2036075,202963,1833112,11.879,119.167,10550,4470,6080,0.262,0.617,2025525,118.549,1.235,0,0,0
1992,i) 2,527111,537224,2907734,1453867,537224,200.000,0,0.000,2907734,2907734,0,200.000,200.000,0,0,0,0.000,0.000,2907734,200.000,0.000,0,0,0
1993,a) -2,0,0,0,1397496,0,0.000,490262,200.000,0,0,0,0.000,0.000,2794991,2794991,0,200.000,200.000,-2794991,-200.000,0.000,386320,398424,2316616
1993,b) (-2 to -0.8],143056,155532,644795,1564419,439,0.276,7982,5.011,16939,3852,13087,0.246,1.083,1867935,184507,1683428,11.794,119.401,-1850996,-118.318,2.166,0,0,0
1993,c) (-0.8 to -0.2],644597,746661,6624001,8165721,5609,0.746,15038,2.001,167265,64032,103233,0.784,2.048,3256054,282278,2973776,3.457,39.875,-3088789,-37.826,4.097,0,0,0
1993,d) (-0.2 to -0.01],343241,734604,25692769,26696705,24720,3.334,38531,5.196,1565935,517090,1048845,1.937,5.866,3567243,710795,2856448,2.662,13.362,-2001308,-7.496,11.731,0,0,0
1993,e) (-0.01 to 0.01),1521997,1632411,11361182,11359268,4781,0.293,4170,0.255,293893,78455,215438,0.691,2.587,290416,60739,229677,0.535,2.557,3477,0.031,5.113,0,0,0
1993,f) [0.01 to 0.2),395995,808780,29528080,28388263,32292,4.023,20085,2.502,3553050,716396,2836654,2.524,12.516,1269992,349457,920535,1.231,4.474,2283058,8.042,8.947,0,0,0
1993,g) [0.2 to 0.8),733493,876321,13683089,11585727,18906,2.173,6141,0.706,4452706,448634,4004072,3.872,38.433,243591,74491,169100,0.643,2.103,4209115,36.330,4.205,0,0,0
1993,h) [0.8 to 2),157061,167060,2637525,1657566,2677,1.613,438,0.264,1982845,100752,1882093,6.078,119.624,8309,3379,4930,0.204,0.501,1974536,119.123,1.003,0,0,0
1993,i) 2,555885,560729,2926828,1463414,560729,200.000,0,0.000,2926828,2926828,0,200.000,200.000,0,0,0,0.000,0.000,2926828,200.000,0.000,0,0,0
1994,a) -2,0,0,0,1458481,0,0.000,501810,200.000,0,0,0,0.000,0.000,2916962,2916962,0,200.000,200.000,-2916962,-200.000,0.000,398829,410734,2473855
1994,b) (-2 to -0.8],159175,168102,602409,1521307,591,0.345,7066,4.124,8856,4728,4128,0.311,0.582,1860541,108714,1751827,7.146,122.299,-1851685,-121.717,1.164,0,0,0
1994,c) (-0.8 to -0.2],649743,731709,6313751,7742912,5464,0.743,12812,1.742,171615,76284,95331,0.985,2.216,3041667,282289,2759378,3.646,39.283,-2870052,-37.067,4.433,0,0,0
1994,d) (-0.2 to -0.01],342132,687049,23993156,24977226,23081,3.350,26901,3.905,1288669,496605,792064,1.988,5.159,3254359,646727,2607632,2.589,13.029,-1965690,-7.870,10.319,0,0,0
1994,e) (-0.01 to 0.01),1534485,1668397,12151603,12151382,7698,0.462,5081,0.305,383080,126760,256320,1.043,3.153,379549,98580,280969,0.811,3.124,3531,0.029,6.247,0,0,0
1994,f) [0.01 to 0.2),416850,897078,33076338,31776052,42104,4.753,19754,2.230,3932741,880009,3052732,2.769,12.376,1329897,367541,962356,1.157,4.185,2602844,8.191,8.370,0,0,0
1994,g) [0.2 to 0.8),760986,911042,14063946,11863176,29557,3.285,6915,0.769,4702830,637206,4065624,5.371,39.642,290776,103538,187238,0.873,2.451,4412054,37.191,4.902,0,0,0
1994,h) [0.8 to 2),148282,158369,2423385,1537452,4112,2.627,380,0.243,1792249,126656,1665593,8.238,116.573,7579,3328,4251,0.216,0.493,1784670,116.080,0.986,0,0,0
1994,i) 2,563408,569449,3020027,1510014,569449,200.000,0,0.000,3020027,3020027,0,200.000,200.000,0,0,0,0.000,0.000,3020027,200.000,0.000,0,0,0
1995,a) -2,0,0,0,1430274,0,0.000,499765,200.000,0,0,0,0.000,0.000,2860548,2860548,0,200.000,200.000,-2860548,-200.000,0.000,398626,411668,2465275
1995,b) (-2 to -0.8],134980,142657,511039,1289969,409,0.281,6166,4.237,7808,4276,3532,0.331,0.605,1579152,130234,1448918,10.096,122.418,-1571344,-121.813,1.211,0,0,0
1995,c) (-0.8 to -0.2],631589,710717,6055044,7436656,5879,0.824,11031,1.546,160951,82001,78950,1.103,2.164,2936580,243744,2692836,3.278,39.488,-2775629,-37.324,4.329,0,0,0
1995,d) (-0.2 to -0.01],344623,699073,23752081,24687155,26119,3.732,27830,3.976,1222554,476955,745599,1.932,4.952,3091193,573824,2517369,2.324,12.521,-1868639,-7.569,9.904,0,0,0
1995,e) (-0.01 to 0.01),1595407,1732639,12365067,12364261,6933,0.400,5030,0.290,337938,98043,239895,0.793,2.733,335619,80055,255564,0.647,2.714,2319,0.019,5.429,0,0,0
1995,f) [0.01 to 0.2),435844,941965,35505256,34085346,43110,4.634,19587,2.106,4288677,1011770,3276907,2.968,12.582,1451053,348823,1102230,1.023,4.257,2837624,8.325,8.514,0,0,0
1995,g) [0.2 to 0.8),792311,938526,15164949,12814988,27051,2.917,4973,0.536,5021486,704480,4317006,5.497,39.184,310609,74672,235937,0.583,2.424,4710877,36.761,4.848,0,0,0
1995,h) [0.8 to 2),153404,163723,2497246,1586983,4370,2.702,362,0.224,1845268,144695,1700573,9.118,116.275,11824,4717,7107,0.297,0.745,1833444,115.530,1.490,0,0,0
1995,i) 2,585623,592397,3157201,1578601,592397,200.000,0,0.000,3157201,3157201,0,200.000,200.000,0,0,0,0.000,0.000,3157201,200.000,0.000,0,0,0
1996,a) -2,0,0,0,1538968,0,0.000,522351,200.000,0,0,0,0.000,0.000,3077935,3077935,0,200.000,200.000,-3077935,-200.000,0.000,416571,429214,2630186
1996,b) (-2 to -0.8],138544,148270,558114,1419914,476,0.314,7272,4.795,10028,7613,2415,0.536,0.706,1748067,144442,1603625,10.173,123.111,-1738039,-122.405,1.412,0,0,0
1996,c) (-0.8 to -0.2],664799,765506,7034063,8638557,6234,0.812,10916,1.422,181799,79834,101965,0.924,2.105,3399177,241289,3157888,2.793,39.349,-3217378,-37.244,4.209,0,0,0
1996,d) (-0.2 to -0.01],369428,743123,26477685,27524695,24382,3.274,27602,3.706,1411744,534283,877461,1.941,5.129,3503910,617158,2886752,2.242,12.730,-2092166,-7.601,10.258,0,0,0
1996,e) (-0.01 to 0.01),1637611,1800271,12763935,12766678,9311,0.517,8294,0.461,426347,151049,275298,1.183,3.340,431141,120813,310328,0.946,3.377,-4794,-0.038,6.679,0,0,0
1996,f) [0.01 to 0.2),426181,905926,33657486,32350708,46590,5.227,17391,1.951,4115643,1065663,3049980,3.294,12.722,1500007,367879,1132128,1.137,4.637,2615636,8.085,9.273,0,0,0
1996,g) [0.2 to 0.8),757720,893643,13920656,11746216,25438,2.879,5105,0.578,4633001,617549,4015452,5.257,39.442,276759,77588,199171,0.661,2.356,4356242,37.086,4.712,0,0,0
1996,h) [0.8 to 2),147034,159512,2473467,1570304,5947,3.794,422,0.269,1831126,153356,1677770,9.766,116.610,10939,5326,5613,0.339,0.697,1820187,115.913,1.393,0,0,0
1996,i) 2,579963,582879,3150200,1575100,582879,200.000,0,0.000,3150200,3150200,0,200.000,200.000,0,0,0,0.000,0.000,3150200,200.000,0.000,0,0,0
1997,a) -2,0,0,0,1700511,0,0.000,543576,200.000,0,0,0,0.000,0.000,3401021,3401021,0,200.000,200.000,-3401021,-200.000,0.000,434202,449149,2913273
1997,b) (-2 to -0.8],135200,145762,629700,1553319,773,0.515,9584,6.382,13887,7875,6012,0.507,0.894,1876021,201100,1674921,12.946,120.775,-1862134,-119.881,1.788,0,0,0
1997,c) (-0.8 to -0.2],659635,783405,7837655,9568830,10872,1.376,24585,3.111,356184,167593,188591,1.751,3.722,3828594,465946,3362648,4.869,40.011,-3472410,-36.289,7.445,0,0,0
1997,d) (-0.2 to -0.01],364402,719505,23958700,24916525,26982,3.727,35700,4.932,1531039,544102,986937,2.184,6.145,3444680,781421,2663259,3.136,13.825,-1913641,-7.680,12.289,0,0,0
1997,e) (-0.01 to 0.01),1651097,1754440,11880970,11879933,6795,0.387,7602,0.433,463298,147498,315800,1.242,3.900,461613,126683,334930,1.066,3.886,1685,0.014,7.771,0,0,0
1997,f) [0.01 to 0.2),438419,932623,35791590,34415202,50331,5.457,29560,3.205,4775963,1225629,3550334,3.561,13.877,2021517,636678,1384839,1.850,5.874,2754446,8.004,11.748,0,0,0
1997,g) [0.2 to 0.8),790298,969719,16815450,14213222,37284,3.898,10708,1.120,5639586,857802,4781784,6.035,39.678,420813,150002,270811,1.055,2.961,5218773,36.718,5.921,0,0,0
1997,h) [0.8 to 2),154974,177613,3014408,1903359,11665,6.770,1049,0.609,2264744,312590,1952154,16.423,118.987,29572,10347,19225,0.544,1.554,2235172,117.433,3.107,0,0,0
1997,i) 2,582163,592243,3168498,1584249,592243,200.000,0,0.000,3168498,3168498,0,200.000,200.000,0,0,0,0.000,0.000,3168498,200.000,0.000,0,0,0
1998,a) -2,0,0,0,1539547,0,0.000,522331,200.000,0,0,0,0.000,0.000,3079094,3079094,0,200.000,200.000,-3079094,-200.000,0.000,400468,413211,2474989
1998,b) (-2 to -0.8],144122,154212,619243,1550441,484,0.308,6251,3.979,11746,4632,7114,0.299,0.758,1887018,133778,1753240,8.628,121.709,-1875272,-120.951,1.515,0,0,0
1998,c) (-0.8 to -0.2],684971,782076,7384679,9075959,6895,0.877,14665,1.866,196250,86282,109968,0.951,2.162,3593120,283873,3309247,3.128,39.589,-3396870,-37.427,4.325,0,0,0
1998,d) (-0.2 to -0.01],377589,730692,25263228,26290384,24877,3.398,27780,3.794,1315129,456733,858396,1.737,5.002,3369545,668474,2701071,2.543,12.817,-2054416,-7.814,10.005,0,0,0
1998,e) (-0.01 to 0.01),1693910,1818679,13001340,13003538,7647,0.421,6671,0.367,425978,151717,274261,1.167,3.276,429141,116182,312959,0.893,3.300,-3163,-0.024,6.552,0,0,0
1998,f) [0.01 to 0.2),444551,980717,38401059,36830974,55615,5.759,25722,2.663,5020747,1283094,3737653,3.484,13.632,1881738,544435,1337303,1.478,5.109,3139009,8.523,10.218,0,0,0
1998,g) [0.2 to 0.8),789425,983502,16903445,14294074,32242,3.318,8446,0.869,5621143,750742,4870401,5.252,39.325,400242,123116,277126,0.861,2.800,5220901,36.525,5.600,0,0,0
1998,h) [0.8 to 2),152991,167913,2927538,1850064,5140,3.104,500,0.302,2183453,209941,1973512,11.348,118.020,15340,5905,9435,0.319,0.829,2168113,117.191,1.658,0,0,0
1998,i) 2,565806,569398,3177390,1588695,569398,200.000,0,0.000,3177390,3177390,0,200.000,200.000,0,0,0,0.000,0.000,3177390,200.000,0.000,0,0,0
1999,a) -2,0,0,0,1695799,0,0.000,537195,200.000,0,0,0,0.000,0.000,3391598,3391598,0,200.000,200.000,-3391598,-200.000,0.000,408700,424002,2731114
1999,b) (-2 to -0.8],139632,155311,611329,1560319,1472,0.911,13839,8.569,15685,8760,6925,0.561,1.005,1928639,266436,1662203,17.076,123.605,-1912954,-122.600,2.010,0,0,0
1999,c) (-0.8 to -0.2],675016,789216,8280325,10129881,7987,1.005,19539,2.458,336302,154771,181531,1.528,3.320,4048331,525688,3522643,5.189,39.964,-3712029,-36.644,6.640,0,0,0
1999,d) (-0.2 to -0.01],388585,745749,25744869,26812371,24236,3.243,27626,3.696,1414959,512398,902561,1.911,5.277,3555062,692927,2862135,2.584,13.259,-2140103,-7.982,10.555,0,0,0
1999,e) (-0.01 to 0.01),1728377,1880203,14197743,14198409,7552,0.402,5492,0.292,481389,156521,324868,1.102,3.390,482046,121735,360311,0.857,3.395,-657,-0.005,6.781,0,0,0
1999,f) [0.01 to 0.2),462739,1007616,38700403,37202431,57167,5.771,23036,2.326,4839819,1160637,3679182,3.120,13.009,1852223,500473,1351750,1.345,4.979,2987596,8.031,9.958,0,0,0
1999,g) [0.2 to 0.8),789703,950824,16547407,13976400,33697,3.596,6328,0.675,5585015,947507,4637508,6.779,39.960,430452,119986,310466,0.858,3.080,5154563,36.880,6.160,0,0,0
1999,h) [0.8 to 2),151474,164695,2823282,1789822,6936,4.296,484,0.300,2113673,266068,1847605,14.866,118.094,35066,13913,21153,0.777,1.959,2078607,116.135,3.918,0,0,0
1999,i) 2,547394,552233,2892819,1446410,552233,200.000,0,0.000,2892819,2892819,0,200.000,200.000,0,0,0,0.000,0.000,2892819,200.000,0.000,0,0,0
2000,a) -2,0,0,0,1637993,0,0.000,538858,200.000,0,0,0,0.000,0.000,3275986,3275986,0,200.000,200.000,-3275986,-200.000,0.000,405054,420691,2584824
2000,b) (-2 to -0.8],133218,140766,544544,1409069,410,0.285,6573,4.569,8705,4587,4118,0.326,0.618,1749892,154256,1595636,10.947,124.188,-1741187,-123.570,1.236,0,0,0
2000,c) (-0.8 to -0.2],664279,762095,7948452,9715353,6633,0.865,16125,2.103,334853,135076,199777,1.390,3.447,3880663,528830,3351833,5.443,39.944,-3545810,-36.497,6.893,0,0,0
2000,d) (-0.2 to -0.01],385042,768282,25683377,26724729,27193,3.528,32151,4.171,1384603,485238,899365,1.816,5.181,3462869,647047,2815822,2.421,12.958,-2078266,-7.777,10.362,0,0,0
2000,e) (-0.01 to 0.01),1737759,1880556,13912927,13910639,5065,0.269,3571,0.190,345674,109238,236436,0.785,2.485,341715,68190,273525,0.490,2.457,3959,0.028,4.913,0,0,0
2000,f) [0.01 to 0.2),476402,1054707,41482277,39863809,58363,5.621,25517,2.458,5288796,1322143,3966653,3.317,13.267,2046442,561654,1484788,1.409,5.134,3242354,8.134,10.267,0,0,0
2000,g) [0.2 to 0.8),813566,984585,17914356,15139736,34271,3.532,5815,0.599,6016119,882507,5133612,5.829,39.737,460136,123133,337003,0.813,3.039,5555983,36.698,6.079,0,0,0
2000,h) [0.8 to 2),154779,166479,3121099,1966296,5369,3.275,330,0.201,2342643,252049,2090594,12.818,119.140,19223,6878,12345,0.350,0.978,2323420,118.162,1.955,0,0,0
2000,i) 2,537643,543489,2973945,1486973,543489,200.000,0,0.000,2973945,2973945,0,200.000,200.000,0,0,0,0.000,0.000,2973945,200.000,0.000,0,0,0
2001,a) -2,0,0,0,1786844,0,0.000,549777,200.000,0,0,0,0.000,0.000,3573687,3573687,0,200.000,200.000,-3573687,-200.000,0.000,408275,425798,2823695
2001,b) (-2 to -0.8],144982,155291,659293,1694807,761,0.480,7458,4.701,18915,11053,7862,0.652,1.116,2104549,269245,1835304,15.886,124.176,-2085634,-123.060,2.232,0,0,0
2001,c) (-0.8 to -0.2],709441,832517,9976121,12194333,11989,1.425,29257,3.478,588192,283087,305105,2.321,4.823,5032955,809502,4223453,6.638,41.273,-4444763,-36.449,9.647,0,0,0
2001,d) (-0.2 to -0.01],411547,835486,29427632,30663728,29551,3.528,33960,4.054,1687948,588902,1099046,1.921,5.505,4161190,806010,3355180,2.629,13.570,-2473242,-8.066,11.009,0,0,0
2001,e) (-0.01 to 0.01),1759175,1915960,13981057,13984970,8147,0.425,6700,0.350,420269,136916,283353,0.979,3.005,427280,123892,303388,0.886,3.055,-7011,-0.050,6.010,0,0,0
2001,f) [0.01 to 0.2),458524,994907,38581566,37077452,58151,5.942,25752,2.631,4827414,1312644,3514770,3.540,13.020,1820421,572266,1248155,1.543,4.910,3006993,8.110,9.820,0,0,0
2001,g) [0.2 to 0.8),757830,903086,15367096,12992257,30541,3.427,6931,0.778,5146941,756924,4390017,5.826,39.615,393957,143383,250574,1.104,3.032,4752984,36.583,6.064,0,0,0
2001,h) [0.8 to 2),131709,149221,2823846,1780982,9067,6.232,1616,1.111,2135531,279165,1856366,15.675,119.908,39147,24798,14349,1.392,2.198,2096384,117.709,4.396,0,0,0
2001,i) 2,539818,546073,2945511,1472756,546073,200.000,0,0.000,2945511,2945511,0,200.000,200.000,0,0,0,0.000,0.000,2945511,200.000,0.000,0,0,0
2002,a) -2,0,0,0,2072896,0,0.000,582299,200.000,0,0,0,0.000,0.000,4145792,4145792,0,200.000,200.000,-4145792,-200.000,0.000,424349,439540,3421879
2002,b) (-2 to -0.8],161316,173653,926383,2248560,1118,0.629,9151,5.151,26996,15945,11051,0.709,1.201,2685192,253403,2431789,11.270,119.418,-2658196,-118.218,2.401,0,0,0
2002,c) (-0.8 to -0.2],748406,901580,12019209,14764456,16606,1.829,29426,3.241,679827,326522,353305,2.212,4.604,6184490,775602,5408888,5.253,41.888,-5504663,-37.283,9.209,0,0,0
2002,d) (-0.2 to -0.01],408996,945271,33915145,35419605,46794,4.940,50853,5.368,2461338,983810,1477528,2.778,6.949,5460013,1126748,4333265,3.181,15.415,-2998675,-8.466,13.898,0,0,0
2002,e) (-0.01 to 0.01),1695073,1825661,12202207,12201757,11307,0.620,8329,0.457,431766,167737,264029,1.375,3.539,436512,115126,321386,0.944,3.577,-4746,-0.039,7.077,0,0,0
2002,f) [0.01 to 0.2),423438,882283,32365573,31090311,59616,6.888,26002,3.004,4417908,1277046,3140862,4.108,14.210,1866933,574480,1292453,1.848,6.005,2550975,8.205,12.010,0,0,0
2002,g) [0.2 to 0.8),777158,926427,14081173,11863267,34604,3.785,10172,1.113,4878052,801240,4076812,6.754,41.119,429615,141422,288193,1.192,3.621,4448437,37.498,7.243,0,0,0
2002,h) [0.8 to 2),141371,155661,2610012,1647973,7223,4.740,660,0.433,1969832,207048,1762784,12.564,119.531,31125,12475,18650,0.757,1.889,1938707,117.642,3.777,0,0,0
2002,i) 2,573830,581957,3686772,1843386,581957,200.000,0,0.000,3686772,3686772,0,200.000,200.000,0,0,0,0.000,0.000,3686772,200.000,0.000,0,0,0
2003,a) -2,0,0,0,1608999,0,0.000,546346,200.000,0,0,0,0.000,0.000,3217998,3217998,0,200.000,200.000,-3217998,-200.000,0.000,416540,428295,2631272
2003,b) (-2 to -0.8],152171,163081,732944,1820456,452,0.271,7644,4.586,12215,5045,7170,0.277,0.671,2202427,234085,1968342,12.859,120.982,-2190212,-120.311,1.342,0,0,0
2003,c) (-0.8 to -0.2],723168,871417,9542377,11736561,13906,1.583,28502,3.244,430865,151563,279302,1.291,3.671,4836879,697327,4139552,5.941,41.212,-4406014,-37.541,7.342,0,0,0
2003,d) (-0.2 to -0.01],402657,864105,30515339,31788004,35378,4.073,44467,5.119,1862644,782128,1080516,2.460,5.860,4409812,964535,3445277,3.034,13.873,-2547168,-8.013,11.719,0,0,0
2003,e) (-0.01 to 0.01),1739736,1918330,14446157,14449414,10439,0.544,9257,0.483,454286,160691,293595,1.112,3.144,457856,144863,312993,1.003,3.169,-3570,-0.025,6.288,0,0,0
2003,f) [0.01 to 0.2),447916,956301,35338503,33974163,47394,5.024,21632,2.293,4275641,1043222,3232419,3.071,12.585,1546552,436137,1110415,1.284,4.552,2729089,8.033,9.104,0,0,0
2003,g) [0.2 to 0.8),773160,914725,15620459,13224600,21422,2.361,6703,0.739,5150655,498386,4652269,3.769,38.948,352934,140748,212186,1.064,2.669,4797721,36.279,5.338,0,0,0
2003,h) [0.8 to 2),157739,171699,3061543,1929151,5508,3.255,584,0.345,2292502,160200,2132302,8.304,118.835,15745,6510,9235,0.337,0.816,2276757,118.019,1.632,0,0,0
2003,i) 2,595958,600041,3213313,1606657,600041,200.000,0,0.000,3213313,3213313,0,200.000,200.000,0,0,0,0.000,0.000,3213313,200.000,0.000,0,0,0
2004,a) -2,0,0,0,1594537,0,0.000,542371,200.000,0,0,0,0.000,0.000,3189074,3189074,0,200.000,200.000,-3189074,-200.000,0.000,414441,426506,2652596
2004,b) (-2 to -0.8],140288,155350,674193,1671236,1826,1.159,6327,4.015,28261,16526,11735,0.989,1.691,2032669,255011,1777658,15.259,121.627,-2004408,-119.936,3.382,0,0,0
2004,c) (-0.8 to -0.2],687876,788806,8286870,10174849,7450,0.940,14861,1.875,303452,153688,149764,1.510,2.982,4104480,572194,3532286,5.624,40.339,-3801028,-37.357,5.965,0,0,0
2004,d) (-0.2 to -0.01],417461,907991,30427448,31657707,37239,4.090,42185,4.633,1600402,595470,1004932,1.881,5.055,4059762,880678,3179084,2.782,12.824,-2459360,-7.769,10.111,0,0,0
2004,e) (-0.01 to 0.01),1813089,2010856,16301478,16310079,8251,0.410,7755,0.386,531322,147627,383695,0.905,3.258,546853,137194,409659,0.841,3.353,-15531,-0.095,6.515,0,0,0
2004,f) [0.01 to 0.2),467272,984725,37148285,35694000,41690,4.281,19901,2.044,4354978,927628,3427350,2.599,12.201,1450102,407881,1042221,1.143,4.063,2904876,8.138,8.125,0,0,0
2004,g) [0.2 to 0.8),782564,929648,15163265,12817410,26879,2.919,9257,1.005,5033577,594079,4439498,4.635,39.271,325150,102245,222905,0.798,2.537,4708427,36.735,5.074,0,0,0
2004,h) [0.8 to 2),157149,166596,2868876,1812601,3057,1.851,230,0.139,2134004,130069,2003935,7.176,117.732,8721,3577,5144,0.197,0.481,2125283,117.250,0.962,0,0,0
2004,i) 2,619855,623592,3283099,1641550,623592,200.000,0,0.000,3283099,3283099,0,200.000,200.000,0,0,0,0.000,0.000,3283099,200.000,0.000,0,0,0
2005,a) -2,0,0,0,1598840,0,0.000,564484,200.000,0,0,0,0.000,0.000,3197679,3197679,0,200.000,200.000,-3197679,-200.000,0.000,430610,441887,2655820
2005,b) (-2 to -0.8],176279,184579,744396,1803030,421,0.225,5322,2.846,20358,17360,2998,0.963,1.129,2155079,108533,2046546,6.019,119.525,-2134721,-118.396,2.258,0,0,0
2005,c) (-0.8 to -0.2],762822,876067,8400303,10299254,8032,0.913,15051,1.711,235231,105021,130210,1.020,2.284,4045603,405221,3640382,3.934,39.281,-3810372,-36.997,4.568,0,0,0
2005,d) (-0.2 to -0.01],421321,889198,29606315,30799220,40654,4.563,44253,4.967,1591040,682725,908315,2.217,5.166,3974788,834138,3140650,2.708,12.905,-2383748,-7.740,10.332,0,0,0
2005,e) (-0.01 to 0.01),1806781,2021481,16225527,16224174,9640,0.477,5751,0.285,461511,160099,301412,0.987,2.845,454431,122372,332059,0.754,2.801,7080,0.044,5.602,0,0,0
2005,f) [0.01 to 0.2),465313,1031257,40045078,38559467,49615,4.877,21639,2.127,4647553,1061140,3586413,2.752,12.053,1676632,424555,1252077,1.101,4.348,2970921,7.705,8.696,0,0,0
2005,g) [0.2 to 0.8),761285,886423,14470647,12244289,19672,2.239,4066,0.463,4755409,551155,4204254,4.501,38.838,290008,81335,208673,0.664,2.369,4465401,36.469,4.737,0,0,0
2005,h) [0.8 to 2),141160,149284,2511330,1583179,2894,1.955,357,0.241,1887594,130055,1757539,8.215,119.228,18535,6214,12321,0.393,1.171,1869059,118.057,2.341,0,0,0
2005,i) 2,632236,638664,3433035,1716518,638664,200.000,0,0.000,3433035,3433035,0,200.000,200.000,0,0,0,0.000,0.000,3433035,200.000,0.000,0,0,0
2006,a) -2,0,0,0,1575671,0,0.000,590663,200.000,0,0,0,0.000,0.000,3151341,3151341,0,200.000,200.000,-3151341,-200.000,0.000,460700,471139,2623146
2006,b) (-2 to -0.8],134213,141359,508652,1256388,804,0.565,2576,1.811,8916,5993,2923,0.477,0.710,1518695,80590,1438105,6.414,120.878,-1509779,-120.168,1.419,0,0,0
2006,c) (-0.8 to -0.2],709266,794880,7374092,9009596,6939,0.871,10804,1.356,228898,116093,112805,1.289,2.541,3506106,278020,3228086,3.086,38.915,-3277208,-36.375,5.081,0,0,0
2006,d) (-0.2 to -0.01],432523,882347,28747971,29896473,37712,4.285,33246,3.777,1569888,673813,896075,2.254,5.251,3867325,711440,3155885,2.380,12.936,-2297437,-7.685,10.502,0,0,0
2006,e) (-0.01 to 0.01),1892276,2128809,17446218,17443904,16685,0.785,8963,0.422,614899,216614,398285,1.242,3.525,607087,150337,456750,0.862,3.480,7812,0.045,6.960,0,0,0
2006,f) [0.01 to 0.2),484078,1126528,42898954,41224946,74337,6.734,28935,2.621,5309717,1482257,3827460,3.596,12.880,1966872,518332,1448540,1.257,4.771,3342845,8.109,9.542,0,0,0
2006,g) [0.2 to 0.8),777372,925370,15894853,13435735,31458,3.448,5236,0.574,5334421,721710,4612711,5.372,39.703,406512,111614,294898,0.831,3.026,4927909,36.678,6.051,0,0,0
2006,h) [0.8 to 2),157942,169750,2937739,1857595,5323,3.182,420,0.251,2192311,157611,2034700,8.485,118.019,22661,11484,11177,0.618,1.220,2169650,116.799,2.440,0,0,0
2006,i) 2,668720,672189,3465455,1732728,672189,200.000,0,0.000,3465455,3465455,0,200.000,200.000,0,0,0,0.000,0.000,3465455,200.000,0.000,0,0,0
2007,a) -2,0,0,0,1701080,0,0.000,599959,200.000,0,0,0,0.000,0.000,3402160,3402160,0,200.000,200.000,-3402160,-200.000,0.000,467465,477325,2799410
2007,b) (-2 to -0.8],166504,175079,713592,1743533,795,0.446,6877,3.861,15079,9065,6014,0.520,0.865,2087951,172565,1915386,9.897,119.754,-2072872,-118.889,1.730,0,0,0
2007,c) (-0.8 to -0.2],763381,908911,9946118,12148626,11702,1.280,22446,2.455,424652,185483,239169,1.527,3.495,4843341,564957,4278384,4.650,39.867,-4418689,-36.372,6.991,0,0,0
2007,d) (-0.2 to -0.01],445522,964915,33221569,34511894,42771,4.423,46852,4.845,2137627,776650,1360977,2.250,6.194,4726560,943737,3782823,2.735,13.695,-2588933,-7.502,12.388,0,0,0
2007,e) (-0.01 to 0.01),1928709,2071179,14089782,14092087,8693,0.420,8210,0.396,447593,120261,327332,0.853,3.176,448109,122644,325465,0.870,3.180,-516,-0.004,6.352,0,0,0
2007,f) [0.01 to 0.2),472486,1092974,41043247,39464594,66149,6.143,33793,3.138,5108884,1169413,3939471,2.963,12.945,1957202,554917,1402285,1.406,4.959,3151682,7.986,9.919,0,0,0
2007,g) [0.2 to 0.8),737539,908035,14953117,12660283,33688,3.760,9541,1.065,4959876,644969,4314907,5.094,39.177,367718,131598,236120,1.039,2.905,4592158,36.272,5.809,0,0,0
2007,h) [0.8 to 2),146469,158615,2548434,1603145,5219,3.341,373,0.239,1914311,180858,1733453,11.281,119.410,13633,4441,9192,0.277,0.850,1900678,118.559,1.701,0,0,0
2007,i) 2,632567,639126,3274024,1637012,639126,200.000,0,0.000,3274024,3274024,0,200.000,200.000,0,0,0,0.000,0.000,3274024,200.000,0.000,0,0,0
2008,a) -2,0,0,0,1717707,0,0.000,639134,200.000,0,0,0,0.000,0.000,3435414,3435414,0,200.000,200.000,-3435414,-200.000,0.000,495808,506425,2861728
2008,b) (-2 to -0.8],171906,180850,631129,1566640,413,0.225,5655,3.082,7953,4174,3779,0.266,0.508,1894505,127437,1767068,8.134,120.928,-1886552,-120.420,1.015,0,0,0
2008,c) (-0.8 to -0.2],771684,882296,9152949,11218649,7881,0.889,16297,1.838,322881,147342,175539,1.313,2.878,4459584,415542,4044042,3.704,39.752,-4136703,-36.873,5.756,0,0,0
2008,d) (-0.2 to -0.01],453892,1082520,33884306,35243452,43729,4.029,49448,4.556,2021137,703496,1317641,1.996,5.735,4743454,893438,3850016,2.535,13.459,-2722317,-7.724,11.470,0,0,0
2008,e) (-0.01 to 0.01),1956129,2146419,15914767,15917965,11407,0.532,7374,0.344,475173,151822,323351,0.954,2.985,479049,101446,377603,0.637,3.009,-3876,-0.024,5.970,0,0,0
2008,f) [0.01 to 0.2),469245,1004731,40648975,39158109,48023,4.832,26082,2.625,4723239,1014509,3708730,2.591,12.062,1746431,482702,1263729,1.233,4.460,2976808,7.602,8.920,0,0,0
2008,g) [0.2 to 0.8),704577,856971,13901883,11785314,23922,2.819,6959,0.820,4597663,537641,4060022,4.562,39.012,352643,127358,225285,1.081,2.992,4245020,36.020,5.984,0,0,0
2008,h) [0.8 to 2),140209,151430,2511433,1566695,5359,3.598,372,0.250,1912531,135523,1777008,8.650,122.074,12493,5993,6500,0.383,0.797,1900038,121.277,1.595,0,0,0
2008,i) 2,564591,570635,2932399,1466200,570635,200.000,0,0.000,2932399,2932399,0,200.000,200.000,0,0,0,0.000,0.000,2932399,200.000,0.000,0,0,0
2009,a) -2,0,0,0,1827351,0,0.000,682970,200.000,0,0,0,0.000,0.000,3654702,3654702,0,200.000,200.000,-3654702,-200.000,0.000,511486,524436,3059694
2009,b) (-2 to -0.8],186930,197382,814980,2015076,480,0.241,4770,2.391,9386,5995,3391,0.298,0.466,2423738,114500,2309238,5.682,120.280,-2414352,-119.814,0.932,0,0,0
2009,c) (-0.8 to -0.2],866268,1034185,12716010,15559811,9253,0.891,18190,1.751,393533,170804,222729,1.098,2.529,6087105,473701,5613404,3.044,39.121,-5693572,-36.592,5.058,0,0,0
2009,d) (-0.2 to -0.01],495627,1247037,40384351,42113927,52869,4.224,62068,4.959,2157021,875324,1281697,2.078,5.122,5616728,908153,4708575,2.156,13.337,-3459707,-8.215,10.244,0,0,0
2009,e) (-0.01 to 0.01),1932064,2114755,15063833,15061899,6908,0.327,4976,0.235,367006,133220,233786,0.884,2.437,365982,71055,294927,0.472,2.430,1024,0.007,4.860,0,0,0
2009,f) [0.01 to 0.2),386692,834048,31056071,29986512,39504,4.803,16469,2.002,3411014,813495,2597519,2.713,11.375,1270179,327119,943060,1.091,4.236,2140835,7.139,8.472,0,0,0
2009,g) [0.2 to 0.8),594755,671079,9036018,7661068,12646,1.898,3039,0.456,2923096,295630,2627466,3.859,38.155,161281,41649,119632,0.544,2.105,2761815,36.050,4.210,0,0,0
2009,h) [0.8 to 2),126138,132943,2020388,1257787,2775,2.108,207,0.157,1544806,78085,1466721,6.208,122.819,6878,3291,3587,0.262,0.547,1537928,122.273,1.094,0,0,0
2009,i) 2,501818,509129,2600032,1300016,509129,200.000,0,0.000,2600032,2600032,0,200.000,200.000,0,0,0,0.000,0.000,2600032,200.000,0.000,0,0,0
2010,a) -2,0,0,0,1487872,0,0.000,604996,200.000,0,0,0,0.000,0.000,2975744,2975744,0,200.000,200.000,-2975744,-200.000,0.000,440520,453105,2411858
2010,b) (-2 to -0.8],151404,158939,581290,1513305,387,0.241,3225,2.011,6341,4467,1874,0.295,0.419,1883499,101552,1781947,6.711,124.463,-1877158,-124.044,0.838,0,0,0
2010,c) (-0.8 to -0.2],739740,865164,8904400,10828839,7942,0.912,19878,2.282,251270,104988,146282,0.970,2.320,4117666,384940,3732726,3.555,38.025,-3866396,-35.705,4.641,0,0,0
2010,d) (-0.2 to -0.01],476609,1201338,39435728,41018196,43553,3.616,49828,4.137,1860202,690238,1169964,1.683,4.535,5025558,821088,4204470,2.002,12.252,-3165356,-7.717,9.070,0,0,0
2010,e) (-0.01 to 0.01),1986911,2207428,16733562,16735941,7520,0.341,5775,0.262,409294,112729,296565,0.674,2.446,417298,91423,325875,0.546,2.493,-8004,-0.048,4.891,0,0,0
2010,f) [0.01 to 0.2),408923,884946,31088635,29999422,36756,4.194,19683,2.246,3371042,645647,2725395,2.152,11.237,1190330,272190,918140,0.907,3.968,2180712,7.269,7.936,0,0,0
2010,g) [0.2 to 0.8),624618,706548,9922824,8376526,14036,2.001,3641,0.519,3327889,336245,2991644,4.014,39.729,220761,80093,140668,0.956,2.635,3107128,37.093,5.271,0,0,0
2010,h) [0.8 to 2),116633,123387,1878947,1177254,2418,1.978,177,0.145,1422112,102746,1319366,8.728,120.799,9127,4797,4330,0.407,0.775,1412985,120.024,1.551,0,0,0
2010,i) 2,513975,524307,2764569,1382285,524307,200.000,0,0.000,2764569,2764569,0,200.000,200.000,0,0,0,0.000,0.000,2764569,200.000,0.000,0,0,0
2011,a) -2,0,0,0,1372801,0,0.000,572430,200.000,0,0,0,0.000,0.000,2745601,2745601,0,200.000,200.000,-2745601,-200.000,0.000,420718,433755,2213182
2011,b) (-2 to -0.8],136855,143981,518698,1288061,260,0.179,2276,1.570,3556,2227,1329,0.173,0.276,1554251,64646,1489605,5.019,120.666,-1550695,-120.390,0.552,0,0,0
2011,c) (-0.8 to -0.2],663283,737154,6178738,7567003,5751,0.778,8983,1.216,164327,73584,90743,0.972,2.172,2955065,195784,2759281,2.587,39.052,-2790738,-36.880,4.343,0,0,0
2011,d) (-0.2 to -0.01],428471,978762,30871489,31969322,35664,3.631,42797,4.357,1474596,531459,943137,1.662,4.613,3673139,654399,3018740,2.047,11.490,-2198543,-6.877,9.225,0,0,0
2011,e) (-0.01 to 0.01),1974347,2234038,17330755,17332470,8233,0.369,7792,0.349,428578,100110,328468,0.578,2.473,429569,116830,312739,0.674,2.478,-991,-0.006,4.945,0,0,0
2011,f) [0.01 to 0.2),457475,1106772,40846496,39385510,50843,4.650,24235,2.216,4489161,866143,3623018,2.199,11.398,1566839,372802,1194037,0.947,3.978,2922322,7.420,7.956,0,0,0
2011,g) [0.2 to 0.8),677292,798121,12461153,10573376,18348,2.320,3838,0.485,4026745,353821,3672924,3.346,38.084,246022,73498,172524,0.695,2.327,3780723,35.757,4.654,0,0,0
2011,h) [0.8 to 2),123754,131645,2115733,1337117,2790,2.137,589,0.451,1590392,78455,1511937,5.867,118.942,24181,18496,5685,1.383,1.808,1566211,117.133,3.617,0,0,0
2011,i) 2,534382,538036,2556304,1278152,538036,200.000,0,0.000,2556304,2556304,0,200.000,200.000,0,0,0,0.000,0.000,2556304,200.000,0.000,0,0,0
2012,a) -2,0,0,0,1343363,0,0.000,516130,200.000,0,0,0,0.000,0.000,2686725,2686725,0,200.000,200.000,-2686725,-200.000,0.000,380124,392454,2205602
2012,b) (-2 to -0.8],114581,121638,430763,1075484,354,0.286,4361,3.527,4955,2123,2832,0.197,0.461,1306388,79684,1226704,7.409,121.470,-1301433,-121.009,0.921,0,0,0
2012,c) (-0.8 to -0.2],621664,729452,6712203,8185544,4855,0.660,17649,2.398,270353,99478,170875,1.215,3.303,3227256,368271,2858985,4.499,39.426,-2956903,-36.123,6.606,0,0,0
2012,d) (-0.2 to -0.01],418943,937542,28232498,29326895,31545,3.350,39472,4.192,1408661,378051,1030610,1.289,4.803,3595652,611513,2984139,2.085,12.261,-2186991,-7.457,9.607,0,0,0
2012,e) (-0.01 to 0.01),2013496,2242888,18407808,18405938,8388,0.374,8454,0.377,509111,142254,366857,0.773,2.766,503578,101892,401686,0.554,2.736,5533,0.030,5.472,0,0,0
2012,f) [0.01 to 0.2),478444,1143241,43434294,41864322,47300,4.165,32112,2.828,4876920,815483,4061437,1.948,11.649,1735618,456197,1279421,1.090,4.146,3141302,7.504,8.292,0,0,0
2012,g) [0.2 to 0.8),717303,843338,13228060,11192917,16001,1.909,5854,0.698,4305599,339935,3965664,3.037,38.467,230673,85543,145130,0.764,2.061,4074926,36.406,4.122,0,0,0
2012,h) [0.8 to 2),126459,137385,2084144,1317577,3827,2.821,397,0.293,1551557,104921,1446636,7.963,117.758,8632,3972,4660,0.301,0.655,1542925,117.103,1.310,0,0,0
2012,i) 2,551785,558083,2823723,1411862,558083,200.000,0,0.000,2823723,2823723,0,200.000,200.000,0,0,0,0.000,0.000,2823723,200.000,0.000,0,0,0
2013,a) -2,0,0,0,1365373,0,0.000,515717,200.000,0,0,0,0.000,0.000,2730746,2730746,0,200.000,200.000,-2730746,-200.000,0.000,384914,392695,2217436
2013,b) (-2 to -0.8],112259,119617,419614,1045410,371,0.306,3631,2.995,6189,2904,3285,0.278,0.592,1268682,88973,1179709,8.511,121.357,-1262493,-120.765,1.184,0,0,0
2013,c) (-0.8 to -0.2],634772,737151,6699235,8165291,9337,1.262,14210,1.921,197517,79601,117916,0.975,2.419,3142183,291804,2850379,3.574,38.482,-2944666,-36.063,4.838,0,0,0
2013,d) (-0.2 to -0.01],428482,964810,30859285,32005506,29579,3.044,43413,4.468,1376231,478184,898047,1.494,4.300,3669696,646668,3023028,2.020,11.466,-2293465,-7.166,8.600,0,0,0
2013,e) (-0.01 to 0.01),2050409,2272325,18781883,18781659,10025,0.442,6496,0.286,516470,156482,359988,0.833,2.750,514236,122553,391683,0.653,2.738,2234,0.012,5.476,0,0,0
2013,f) [0.01 to 0.2),487476,1144146,42324374,40752539,52554,4.636,31314,2.763,4878943,950779,3928164,2.333,11.972,1738731,491725,1247006,1.207,4.267,3140212,7.706,8.533,0,0,0
2013,g) [0.2 to 0.8),705893,853040,13942340,11819864,20669,2.446,4693,0.555,4529777,549130,3980647,4.646,38.323,280703,92890,187813,0.786,2.375,4249074,35.949,4.750,0,0,0
2013,h) [0.8 to 2),117604,128242,1998079,1277177,4463,3.537,355,0.281,1463215,106982,1356233,8.376,114.566,9678,3446,6232,0.270,0.758,1453537,113.809,1.516,0,0,0
2013,i) 2,530629,534130,2577469,1288735,534130,200.000,0,0.000,2577469,2577469,0,200.000,200.000,0,0,0,0.000,0.000,2577469,200.000,0.000,0,0,0
2014,a) -2,0,0,0,1297917,0,0.000,511695,200.000,0,0,0,0.000,0.000,2595833,2595833,0,200.000,200.000,-2595833,-200.000,0.000,382354,390861,2127232
2014,b) (-2 to -0.8],106299,114009,471738,1107928,524,0.453,3622,3.134,49893,16769,S,1.514,4.503,1331124,152975,1178149,13.807,120.145,-1281231,-115.642,9.007,0,0,0
2014,c) (-0.8 to -0.2],619594,706614,6353059,7729994,4067,0.573,9915,1.397,189176,74075,115101,0.958,2.447,2953366,235016,2718350,3.040,38.207,-2764190,-35.759,4.895,0,0,0
2014,d) (-0.2 to -0.01],434323,947514,29838729,30969894,32990,3.471,39077,4.111,1276859,409798,867061,1.323,4.123,3536820,614898,2921922,1.985,11.420,-2259961,-7.297,8.246,0,0,0
2014,e) (-0.01 to 0.01),2071261,2324838,20414866,20407848,9530,0.410,5970,0.257,491184,161191,329993,0.790,2.407,476372,96911,379461,0.475,2.334,14812,0.073,4.669,0,0,0
2014,f) [0.01 to 0.2),506524,1236026,45395642,43718555,64870,5.330,27039,2.222,5159014,1180189,3978825,2.700,11.801,1809574,467435,1342139,1.069,4.139,3349440,7.661,8.278,0,0,0
2014,g) [0.2 to 0.8),714312,830844,12920099,10978385,15888,1.926,3671,0.445,4210716,405316,3805400,3.692,38.355,325456,130470,194986,1.188,2.965,3885260,35.390,5.929,0,0,0
2014,h) [0.8 to 2),117369,124765,2005680,1271393,3196,2.593,195,0.158,1488181,102737,1385444,8.081,117.051,10212,2817,7395,0.222,0.803,1477969,116.248,1.606,0,0,0
2014,i) 2,534827,541612,2724970,1362485,541612,200.000,0,0.000,2724970,2724970,0,200.000,200.000,0,0,0,0.000,0.000,2724970,200.000,0.000,0,0,0
2015,a) -2,0,0,0,1365719,0,0.000,510532,200.000,0,0,0,0.000,0.000,2731438,2731438,0,200.000,200.000,-2731438,-200.000,0.000,383683,393440,2235726
2015,b) (-2 to -0.8],104733,110607,377553,942115,261,0.233,2853,2.550,6188,3177,3011,0.337,0.657,1145632,64878,1080754,6.886,121.602,-1139445,-120.945,1.314,0,0,0
2015,c) (-0.8 to -0.2],619497,707209,6156559,7512710,5006,0.705,10722,1.510,174574,69664,104910,0.927,2.324,2897755,230915,2666840,3.074,38.571,-2723181,-36.248,4.647,0,0,0
2015,d) (-0.2 to -0.01],436299,983951,30933481,32060906,32756,3.314,41953,4.244,1651724,575523,1076201,1.795,5.152,3905861,657279,3248582,2.050,12.183,-2254137,-7.031,10.304,0,0,0
2015,e) (-0.01 to 0.01),2083662,2362078,19820040,19815731,8833,0.374,8311,0.352,549796,155202,394594,0.783,2.775,539157,159466,379691,0.805,2.721,10639,0.054,5.442,0,0,0
2015,f) [0.01 to 0.2),520635,1214852,47381768,45588906,59999,5.011,24891,2.079,5246183,1117255,4128928,2.451,11.508,1660765,375362,1285403,0.823,3.643,3585418,7.865,7.286,0,0,0
2015,g) [0.2 to 0.8),724091,855599,13897343,11814027,28714,3.401,5920,0.701,4500898,600021,3900877,5.079,38.098,326240,77300,248940,0.654,2.761,4174658,35.336,5.523,0,0,0
2015,h) [0.8 to 2),118313,126401,1894256,1198190,3609,2.895,175,0.140,1408468,108270,1300198,9.036,117.550,7654,2036,5618,0.170,0.639,1400814,116.911,1.278,0,0,0
2015,i) 2,543886,550601,2769846,1384923,550601,200.000,0,0.000,2769846,2769846,0,200.000,200.000,0,0,0,0.000,0.000,2769846,200.000,0.000,0,0,0
2016,a) -2,0,0,0,1407769,0,0.000,511442,200.000,0,0,0,0.000,0.000,2815538,2815538,0,200.000,200.000,-2815538,-200.000,0.000,385840,395735,2316597
2016,b) (-2 to -0.8],107361,114331,497581,1192001,372,0.321,3468,2.993,31172,5360,25812,0.450,2.615,1433000,117257,1315743,9.837,120.218,-1401828,-117.603,5.230,0,0,0
2016,c) (-0.8 to -0.2],630750,716435,6489266,7913853,6253,0.870,10054,1.400,156531,74692,81839,0.944,1.978,3013036,199801,2813235,2.525,38.073,-2856505,-36.095,3.956,0,0,0
2016,d) (-0.2 to -0.01],442734,950879,30409656,31633150,29593,3.116,27265,2.871,1365668,462625,903043,1.462,4.317,3816290,608559,3207731,1.924,12.064,-2450622,-7.747,8.634,0,0,0
2016,e) (-0.01 to 0.01),2091868,2380057,19511635,19510164,10050,0.423,5954,0.250,445938,133637,312301,0.685,2.286,441403,78473,362930,0.402,2.262,4535,0.023,4.525,0,0,0
2016,f) [0.01 to 0.2),525136,1293934,50132774,48325149,62808,4.934,20950,1.646,5307004,1054199,4252805,2.181,10.982,1692318,383700,1308618,0.794,3.502,3614686,7.480,7.004,0,0,0
2016,g) [0.2 to 0.8),733970,882490,14064360,11945588,27578,3.163,6395,0.733,4583782,619893,3963889,5.189,38.372,335033,90659,244374,0.759,2.805,4248749,35.568,5.609,0,0,0
2016,h) [0.8 to 2),120229,128380,1836131,1163625,4072,3.221,190,0.150,1363369,107673,1255696,9.253,117.166,8858,2038,6820,0.175,0.761,1354511,116.404,1.522,0,0,0
2016,i) 2,564640,569967,2805497,1402749,569967,200.000,0,0.000,2805497,2805497,0,200.000,200.000,0,0,0,0.000,0.000,2805497,200.000,0.000,0,0,0
2017,a) -2,0,0,0,1515936,0,0.000,526175,200.000,0,0,0,0.000,0.000,3031871,3031871,0,200.000,200.000,-3031871,-200.000,0.000,395513,406682,2464056
2017,b) (-2 to -0.8],112766,122217,461702,1199062,300,0.237,8712,6.891,12071,4481,7590,0.374,1.007,1498875,150589,1348286,12.559,125.004,-1486804,-123.997,2.013,0,0,0
2017,c) (-0.8 to -0.2],669603,799948,8069075,9816963,7679,0.952,20339,2.523,317994,111096,206898,1.132,3.239,3829743,471960,3357783,4.808,39.011,-3511749,-35.772,6.478,0,0,0
2017,d) (-0.2 to -0.01],458679,1021064,32533022,33815852,24270,2.360,39126,3.804,1552586,440791,1111795,1.304,4.591,4122416,734921,3387495,2.173,12.191,-2569830,-7.599,9.183,0,0,0
2017,e) (-0.01 to 0.01),2111612,2380662,21010900,21008527,7635,0.321,8308,0.349,562938,119829,443109,0.570,2.680,555215,147363,407852,0.701,2.643,7723,0.037,5.286,0,0,0
2017,f) [0.01 to 0.2),509398,1171330,44904802,43273381,46439,3.991,30749,2.643,4950161,895812,4054349,2.070,11.439,1693611,451226,1242385,1.043,3.914,3256550,7.526,7.827,0,0,0
2017,g) [0.2 to 0.8),720613,890900,15356441,12970972,29128,3.311,6840,0.777,5164189,709484,4454705,5.470,39.813,383947,149569,234378,1.153,2.960,4780242,36.853,5.920,0,0,0
2017,h) [0.8 to 2),113979,129921,2322497,1469113,5615,4.406,664,0.521,1744936,212630,1532306,14.473,118.775,28404,22549,5855,1.535,1.933,1716532,116.841,3.867,0,0,0
2017,i) 2,555159,562234,2822413,1411207,562234,200.000,0,0.000,2822413,2822413,0,200.000,200.000,0,0,0,0.000,0.000,2822413,200.000,0.000,0,0,0
2018,a) -2,0,0,0,1453531,0,0.000,530675,200.000,0,0,0,0.000,0.000,2907061,2907061,0,200.000,200.000,-2907061,-200.000,0.000,398175,409005,2361596
2018,b) (-2 to -0.8],107128,120633,493731,1191904,298,0.245,2486,2.042,9783,6009,3774,0.504,0.821,1416235,83174,1333061,6.978,118.821,-1406452,-118.000,1.642,0,0,0
2018,c) (-0.8 to -0.2],660909,782768,7592785,9322107,4183,0.530,17067,2.163,178718,67754,110964,0.727,1.917,3645050,307887,3337163,3.303,39.101,-3466332,-37.184,3.834,0,0,0
2018,d) (-0.2 to -0.01],462843,1019764,34004210,35333370,25210,2.457,38149,3.717,1384348,437653,946695,1.239,3.918,4029019,688480,3340539,1.949,11.403,-2644671,-7.485,7.836,0,0,0
2018,e) (-0.01 to 0.01),2141521,2437530,20664446,20657117,5975,0.245,6909,0.283,379709,111232,268477,0.538,1.838,364466,93306,271160,0.452,1.764,15243,0.074,3.529,0,0,0
2018,f) [0.01 to 0.2),512351,1155892,46514323,44825168,44132,3.852,23804,2.078,4911109,851176,4059933,1.899,10.956,1536153,348911,1187242,0.778,3.427,3374956,7.529,6.854,0,0,0
2018,g) [0.2 to 0.8),721635,892845,15243690,12965531,21861,2.462,11840,1.334,4996978,538909,4458069,4.156,38.540,437349,210721,226628,1.625,3.373,4559629,35.167,6.746,0,0,0
2018,h) [0.8 to 2),122955,134664,2259057,1422584,4419,3.332,316,0.238,1692811,143382,1549429,10.079,118.996,9888,4203,5685,0.295,0.695,1682923,118.300,1.390,0,0,0
2018,i) 2,557579,561926,2913031,1456516,561926,200.000,0,0.000,2913031,2913031,0,200.000,200.000,0,0,0,0.000,0.000,2913031,200.000,0.000,0,0,0
2019,a) -2,0,0,0,1437022,0,0.000,534661,200.000,0,0,0,0.000,0.000,2874043,2874043,0,200.000,200.000,-2874043,-200.000,0.000,410490,419007,2376434
2019,b) (-2 to -0.8],113417,120677,424654,1080335,189,0.155,2985,2.445,3199,1700,1499,0.157,0.296,1327264,111900,1215364,10.358,122.857,-1324065,-122.561,0.592,0,0,0
2019,c) (-0.8 to -0.2],664066,772064,7371120,8909444,6110,0.789,10448,1.349,203985,86710,117275,0.973,2.290,3294855,206126,3088729,2.314,36.982,-3090870,-34.692,4.579,0,0,0
2019,d) (-0.2 to -0.01],476637,1023907,33652792,34929548,24305,2.368,28908,2.817,1226940,397431,829509,1.138,3.513,3777201,540548,3236653,1.548,10.814,-2550261,-7.301,7.025,0,0,0
2019,e) (-0.01 to 0.01),2173563,2548318,24106844,24111964,9324,0.366,7115,0.279,454255,174008,280247,0.722,1.884,463029,145289,317740,0.603,1.920,-8774,-0.036,3.768,0,0,0
2019,f) [0.01 to 0.2),523732,1197869,46865325,45156251,46985,3.968,19652,1.660,4901882,923519,3978363,2.045,10.855,1489285,346972,1142313,0.768,3.298,3412597,7.557,6.596,0,0,0
2019,g) [0.2 to 0.8),700196,823621,14672224,12463879,19209,2.351,6021,0.737,4735794,394069,4341725,3.162,37.996,314535,112672,201863,0.904,2.524,4421259,35.473,5.047,0,0,0
2019,h) [0.8 to 2),111067,118182,1856358,1174787,3073,2.632,217,0.186,1381623,117438,1264185,9.997,117.606,10435,2127,8308,0.181,0.888,1371188,116.718,1.776,0,0,0
2019,i) 2,573116,577847,2930969,1465485,577847,200.000,0,0.000,2930969,2930969,0,200.000,200.000,0,0,0,0.000,0.000,2930969,200.000,0.000,0,0,0
2020,a) -2,0,0,0,1555695,0,0.000,586739,200.000,0,0,0,0.000,0.000,3111390,3111390,0,200.000,200.000,-3111390,-200.000,0.000,426546,437361,2485223
2020,b) (-2 to -0.8],113108,128223,468434,1173396,322,0.247,4952,3.794,7048,4032,3016,0.344,0.601,1427809,138160,1289649,11.774,121.682,-1420761,-121.081,1.201,0,0,0
2020,c) (-0.8 to -0.2],694426,812995,8214513,9966422,7478,0.918,10928,1.341,255246,121098,134148,1.215,2.561,3771583,323049,3448534,3.241,37.843,-3516337,-35.282,5.122,0,0,0
2020,d) (-0.2 to -0.01],490359,1062047,35589426,36987036,22493,2.111,29505,2.769,1488310,580151,908159,1.569,4.024,4287512,557498,3730014,1.507,11.592,-2799202,-7.568,8.048,0,0,0
2020,e) (-0.01 to 0.01),2162652,2533255,23544453,23550835,8491,0.335,6313,0.249,515492,128337,387155,0.545,2.189,526631,104815,421816,0.445,2.236,-11139,-0.047,4.378,0,0,0
2020,f) [0.01 to 0.2),503649,1156748,46397449,44739262,46980,4.100,25413,2.218,4909474,899474,4010000,2.010,10.974,1602466,425223,1177243,0.950,3.582,3307008,7.392,7.164,0,0,0
2020,g) [0.2 to 0.8),686771,808943,13826700,11777903,17163,2.138,4648,0.579,4383805,609763,3774042,5.177,37.221,279978,111992,167986,0.951,2.377,4103827,34.843,4.754,0,0,0
2020,h) [0.8 to 2),110212,117024,1771217,1113237,3327,2.883,97,0.084,1331702,91174,1240528,8.190,119.624,6872,1457,5415,0.131,0.617,1324830,119.007,1.235,0,0,0
2020,i) 2,579795,587513,2925054,1462527,587513,200.000,0,0.000,2925054,2925054,0,200.000,200.000,0,0,0,0.000,0.000,2925054,200.000,0.000,0,0,0
2021,a) -2,0,0,0,1566819,0,0.000,615648,200.000,0,0,0,0.000,0.000,3133638,3133638,0,200.000,200.000,-3133638,-200.000,0.000,439760,456248,2441755
2021,b) (-2 to -0.8],148481,172165,969182,2283340,748,0.423,10424,5.889,20318,7877,12441,0.345,0.890,2658976,191312,2467664,8.379,116.451,-2638658,-115.561,1.780,0,0,0
2021,c) (-0.8 to -0.2],825435,1098324,15316863,18878414,14977,1.354,30966,2.799,405318,212685,192633,1.127,2.147,7535692,477601,7058091,2.530,39.917,-7130374,-37.770,4.294,0,0,0
2021,d) (-0.2 to -0.01],493614,1165957,40027477,41800821,35466,3.033,42454,3.630,1699617,606023,1093594,1.450,4.066,5246542,713547,4532995,1.707,12.551,-3546925,-8.485,8.132,0,0,0
2021,e) (-0.01 to 0.01),2052135,2334023,19264082,19258334,8764,0.376,5870,0.252,397357,123924,273433,0.643,2.063,387241,70246,316995,0.365,2.011,10116,0.053,4.022,0,0,0
2021,f) [0.01 to 0.2),398827,893369,34621705,33314698,39833,4.505,21600,2.443,4009289,821427,3187862,2.466,12.035,1388660,388354,1000306,1.166,4.168,2620629,7.866,8.337,0,0,0
2021,g) [0.2 to 0.8),699359,799023,11916545,10100621,17479,2.206,4254,0.537,3905550,369575,3535975,3.659,38.666,265210,72626,192584,0.719,2.626,3640340,36.041,5.251,0,0,0
2021,h) [0.8 to 2),125123,133442,2026073,1279366,4324,3.292,145,0.110,1513199,113344,1399855,8.859,118.277,9408,2408,7000,0.188,0.735,1503791,117.542,1.471,0,0,0
2021,i) 2,654482,663012,2990422,1495211,663012,200.000,0,0.000,2990422,2990422,0,200.000,200.000,0,0,0,0.000,0.000,2990422,200.000,0.000,0,0,0
2022,a) -2,0,0,0,1523374,0,0.000,578997,200.000,0,0,0,0.000,0.000,3046747,3046747,0,200.000,200.000,-3046747,-200.000,0.000,485537,501180,2643141
2022,b) (-2 to -0.8],103754,113681,418864,1136726,268,0.230,6128,5.255,6943,1833,5110,0.161,0.611,1453474,218190,1235284,19.195,127.865,-1446531,-127.254,1.222,0,0,0
2022,c) (-0.8 to -0.2],626373,732305,6981647,8538299,5555,0.751,20363,2.753,234029,95371,138658,1.117,2.741,3355425,424114,2931311,4.967,39.299,-3121396,-36.558,5.482,0,0,0
2022,d) (-0.2 to -0.01],401889,906693,29455170,30621381,27417,2.999,42372,4.635,1580270,472385,1107885,1.543,5.161,3904654,658754,3245900,2.151,12.751,-2324384,-7.591,10.321,0,0,0
2022,e) (-0.01 to 0.01),2112894,2403954,20298228,20292981,9793,0.407,10966,0.456,535157,173869,361288,0.857,2.637,522547,178681,343866,0.881,2.575,12610,0.062,5.150,0,0,0
2022,f) [0.01 to 0.2),520505,1215891,47804703,45833605,46983,3.883,35161,2.906,5954257,889442,5064815,1.941,12.991,2021573,595466,1426107,1.299,4.411,3932684,8.580,8.821,0,0,0
2022,g) [0.2 to 0.8),900926,1128622,21944416,18562079,30387,2.715,11191,1.000,7245815,657293,6588522,3.541,39.036,482704,156538,326166,0.843,2.600,6763111,36.435,5.201,0,0,0
2022,h) [0.8 to 2),156815,177802,3411154,2164040,6854,3.923,704,0.403,2519488,216393,2303095,9.999,116.425,14563,5100,9463,0.236,0.673,2504925,115.752,1.346,0,0,0
2022,i) 2,712139,721580,3374849,1687425,721580,200.000,0,0.000,3374849,3374849,0,200.000,200.000,0,0,0,0.000,0.000,3374849,200.000,0.000,0,0,0
